уместнее	ADJ
злой	ADJ
скажи	VERB
сходку	NOUN
моей	PRON
шарю	VERB
нету	X
обществе	NOUN
два	NUM
педофил	NOUN
копия	NOUN
могли	VERB
выйти	VERB
изза	ADP
без	ADP
пхан	X
приходил	VERB
жалкая	ADJ
могу	VERB
красным	ADJ
мной	PRON
пачку	NOUN
купил	VERB
кошмар	NOUN
и	CCONJ
какой	ADJ
наушников	NOUN
энд	CCONJ
спермобак	NOUN
внизу	ADV
ахах	INTJ
зато	CCONJ
свободную	ADJ
покупала	VERB
аватарки	NOUN
добавил	VERB
нее	PRON
считать	VERB
никто	PRON
земли	NOUN
серию	NOUN
тут	PRON
составил	VERB
час	NOUN
упор	NOUN
у	ADP
такую	ADJ
расстроил	VERB
уйти	VERB
начинали	VERB
америки	NOUN
добрый	ADJ
пивас	NOUN
так	ADV
то	PRON
почему	ADV
люди	NOUN
вонючие	ADJ
бедные	ADJ
быть	VERB
чорт	NOUN
зачем	ADV
ведьмы	NOUN
меня	PRON
где	ADV
ахахахах	INTG
кто	PRON
копетс	INTG
бутылочку	NOUN
сосать	VERB
обновление	NOUN
знают	VERB
до	ADP
жду	VERB
надо	AUX
матешой	NOUN
сегодня	ADV
сейчас	ADV
ужасное	ADJ
любит	VERB
фанатов	NOUN
орно	NOUN
кишиневские	ADJ
конца	NOUN
одной	PRON
ой	INTJ
скучаю	VERB
чо	PRON
био	X
думал	VERB
вслух	ADV
мармелад	NOUN
пес	NOUN
дали	VERB
хвхфхвха	INTG
плохой	ADJ
бы	AUX
черновики	NOUN
точно	ADV
хочу	VERB
день	NOUN
росту	NOUN
сам	ADV
тогда	ADV
девочка	NOUN
всем	PRON
прийти	VERB
стекляшки	NOUN
использовать	VERB
нам	PRON
нас	PRON
самом	PRON
универе	NOUN
туда	ADV
зоны	NOUN
хватит	VERB
почемуто	PRON
захват	NOUN
лого	NOUN
угнетатель	NOUN
такто	INTJ
тему	NOUN
войне	NOUN
сессия	NOUN
мягче	ADJ
школа	NOUN
напишут	VERB
идеально	ADV
взять	VERB
плохо	ADV
девочку	NOUN
альбому	NOUN
пхэ	INTJ
сложнее	ADJ
сделать	VERB
родители	NOUN
мгу	NOUN
ужас	NOUN
работает	VERB
банке	NOUN
они	PRON
пол	NOUN
радости	NOUN
одну	ADJ
милота	NOUN
ебаный	ADJ
что	PRON
такое	PRON
видишь	VERB
услвшать	VERB
рожденияя	NOUN
январе	NOUN
мит	X
люблю	VERB
романтики	NOUN
решение	NOUN
тебе	PRON
сюда	ADV
больше	ADV
огромное	ADJ
клубникой	NOUN
вот	PART
тупые	ADJ
поехать	VERB
отсталые	ADJ
видное	ADJ
хорошо	ADV
глаз	NOUN
гуд	ADJ
спи	VERB
пару	NOUN
толька	NOUN
ну	PART
поспоришь	VERB
появился	VERB
максимум	NOUN
вас	PRON
биология	NOUN
рыдаю	VERB
егэ	NOUN
получу	VERB
смогли	VERB
отцы	NOUN
говно	NOUN
матану	NOUN
пристали	VERB
типа	PART
собака	NOUN
есть	VERB
батону	NOUN
химию	NOUN
просто	ADV
момент	NOUN
морса	NOUN
пасха	NOUN
решаю	VERB
другой	ADJ
пугаешь	VERB
дружу	VERB
добилось	VERB
все	PRON
наверное	ADV
сидеть	VERB
законы	NOUN
таки	PART
блятб	INTJ
людей	NOUN
полин	ADJ
редко	ADV
перемещается	VERB
могут	VERB
досрочный	ADJ
остаюсь	VERB
хахаха	INTJ
выгляжу	VERB
ты	PRON
почти	ADV
выпуск	NOUN
хавххаха	INTJ
о	INTJ
спокойной	ADJ
делать	VERB
твоя	PRON
чево	PRON
сколько	PRON
кажется	VERB
послать	VERB
мразь	NOUN
стал	VERB
решить	VERB
других	ADJ
зелень	NOUN
талер	NOUN
хвойных	ADJ
шкаф	NOUN
uwu	INTJ
личка	NOUN
глазкова	NOUN
на	ADP
атб	X
нет	X
маршрутки	NOUN
сказал	VERB
талисман	NOUN
случайно	ADV
соу	PART
че	PRON
привет	INTJ
спасибо	INTJ
да	X
как	SCONJ
купить	VERB
стреляю	VERB
я	PRON
перед	ADP
такой	PRON
чисто	ADV
конечно	ADV
лики	NOUN
нарисованные	ADJ
шаурму	NOUN
себя	PRON
рисовать	VERB
книги	NOUN
несколько	PRON
должны	AUX
старосты	NOUN
сказали	VERB
прошел	VERB
ругаешься	VERB
эхне	INTJ
нафиг	ADV
нами	PRON
сна	NOUN
lp	X
слышал	VERB
хочю	VERB
время	NOUN
отсюда	ADV
сон	NOUN
декабре	NOUN
мечтал	VERB
пизды	NOUN
во	ADP
из	ADP
всегда	ADV
назар	NOUN
золотой	ADJ
убери	VERB
положил	VERB
спид	NOUN
лошка	NOUN
место	NOUN
дима	NOUN
продавец	NOUN